111111111111111111111111111111111
111111111111111111111111111111111
110000000000000000000000000000011
110000000000000000000000000000011
110000000000000000000000000000011
111111100001111110000000000000011
110000100000000010000011111000011
110000100000000010000010000000011
110000100000000011111110000000011
110000100000000000000010000000011
110000100000000000000010000000011
110000100000000000000010000111111
110000000000000000000010000000011
110000000000001111000010000000011
110000000000000001000010000000011
110000000000000001000010000000011
110000000000000001000011111000011
110000000000000001000000001000011
110000000000000001000000001000011
110000011111000001000000001000011
110000010000000001000000001000011
110000010000000001111111111000011
110000010000000001000000000000011
110000010000000001000000000000011
111111110000001111000000000000011
220000000000000001000000000000011
220000000000000001000011111111111
220000000000000001000000000000011
220000000000000000000000000000011
110000111111000000000000000000011
110000000001000000000000000000011
110000000001000000000000000000011
110000000001000000000000000000011
110000000001000001111111111000011
110000100001000001000000000000011
110000100001000001000000000000011
110000100001000001000000000000011
110000100001000001000000000000011
110000100001111111000000000000011
110000100000000000000000000000011
110000100000000000000000000000011
110000000000000000000011110000011
110000000000000000000010000000011
110000000000000000000010000000011
110000000000100000000010000000011
111111110000100000000010000000011
110000000000100000000010000000011
110000000000111111000010000111111
110000000000001000000010000000011
110000000000001000000010000000011
110000000000001000000010000000011
110000000000001000000010000000011
111111111111111111111111111111111
111111111111111111111111111111111