111111111111111111111111111111111
111111111111111111111111111111111
110000000000000000000000000000011
110000000000000000000000000000011
110000000000000000000000000000011
110000000000000000000000000000011
111111111100000000111111000000011
111111111100000000111111000000011
110000001100000000000011000000011
110000001100000000000011000000011
110000000000000000000011111111111
110000000000000000000011111111111
110000000000000000000000000000011
110000000000000000000000000000011
110000000000000000000000000000011
110000000000000000000000000000011
110000001111111111100000000000011
110000001111111111100000000000011
110000001100000000000000000000011
110000001100000000000000000000011
110000001100000000000000000000011
110000001100000000000000000000011
111111111100000000001111111111111
111111111100000000001111111111111
220000000000000000000000000000011
220000000000000000000000000000011
220000000000000000000000000000011
220000000000000000000000000000011
220000000000000000000000000000011
110000000000110000000000000000011
110000000000110000000000000000011
110000000000110000000000000000011
110000000000110000000000000000011
110000000000111111111100000000011
110000000000111111111100000000011
110000000000000000001100000000011
110000000000000000001100000000011
110000000000000000001100000000011
110000000000000000001100000000011
110000000000000000001100000000011
110000000000000000001100000000011
110000000000000000001111111111111
110000000000000000001111111111111
110000000000000000000000000000011
110000000000000000000000000000011
110000000000000000000000000000011
110000000000000000000000000000011
110000000000000000000000000000011
110000000000000000000000000000011
110000000000000000000000000000011
110000000000000000000000000000011
110000000000000000000000000000011
111111111111111111111111111111111
111111111111111111111111111111111